Αγία Σοφία	Μυστράς
Άγιοι Θεόδωροι	Μυστράς
Άγιος Γεώργιος Μήθυμνας	Κίσσαμος
Άγιος Νικόλαος	Μυστράς
Αγορά αρχαίας Ήλιδας	Ήλιδα
Αγορά Κασσώπης	Καμαρίνα Θεσπρωτίας
Αγροτική Τράπεζα Αστακού	Αστακός
Ακαδημία Αθηνών	Αθήνα
Ακρόπολη Δωδώνης	Δωδώνη
Αμαράντειος Σχολή Ρόδου	Ρόδος
Ανάγλυφο του Μίθρα Ταυροκτόνου	Ξάνθη
Ανάθημα του Δαόχου	Δελφοί
Ανακτορικό συγκρότημα Γαλέριου	Θεσσαλονίκη
Ανάκτορο Κνωσού	Κνωσός
Ανάκτορο Αιγών	Βεργίνα
Ανάκτορο Αρχανών	Επάνω Αρχάνες Ηρακλείου
Ανάκτορο Γαλατά	Γαλατάς Ηρακλείου
Ανάκτορο Δημητριάδος	Δημητριάδα
Ανάκτορο Μαλίων	Μάλια
Ανάκτορο Φαιστού	Φαιστός
Ανδριάντας Λεωνίδα	Θερμοπύλες
Ανεμόμυλοι "Σελί Αμπέλου"	Οροπέδιο Λασιθίου
Ανεμόμυλοι Ελούντας	Ελούντα
Ανεμόμυλος Παξών	Παξοί
Ανεμόμυλος Περάματος Γέρας	Πέραμα Λέσβου
Ανεμόμυλος Σώκαρη	Δήμος Πυλαρέων
Ανεξερεύνητη Οικία Κνωσού	Κνωσός
Αποθήκες του Α.Σ.Ο. Κιάτου	Κιάτο
Αρχαία αγορά Θεσσαλονίκης	Θεσσαλονίκη
Αρχαία Δίολκος	Ποσειδωνία
Αρχαϊκός Ναός Τραπεζάς	Κουμάρι Αιγίου Αχαΐας
Αρχαίο Γυμνάσιο Δελφών	Δελφοί
Αρχαίο Γυμνάσιο Ολυμπίας	Ολυμπία
Αρχαίο θέατρο Α΄ Λάρισας	Λάρισα
Αρχαίο θέατρο Άργους	Άργος
Αρχαίο θέατρο Ασκληπιείου Επιδαύρου	Λιγουριό
Αρχαίο θέατρο Β΄ Λάρισας	Λάρισα
Αρχαίο θέατρο Δελφών	Δελφοί
Αρχαίο θέατρο Δίου	Δίον
Αρχαίο θέατρο Δωδώνης	Δωδώνη
Αρχαίο θέατρο Ερέτριας	Ερέτρια
Αρχαίο θέατρο Μαντίνειας	Μαντίνεια
Αρχαίο στάδιο Δελφών	Δελφοί
Αρχαίο στάδιο Δωδώνης	Δωδώνη
Αρχαίο στάδιο Ολυμπίας	Ολυμπία
Αρχαίο τείχος Διστόμου	Δίστομο
Αρχαίο φρούριο στα Φύλλα Ευβοίας	Φύλλα Εύβοιας του Δήμου Ληλαντίων
Αρχαιολογικό Μουσείο Σπάρτης	Σπάρτη
Αρχαιολογικό Μουσείο Τρίπολης	Τρίπολη
Αρχαίος ναός στο Γκορτσούλι	Μαντίνεια
Αρχαίος ναός στον Άγιο Γεώργιο Σκάλας	Σκάλα Κεφαλληνίας
Αρχαίος Ναός της Αθηνάς	Ακρόπολη
Αρχαίος πύργος Αγίας Τριάδας Αμοργού	Αμοργός
Αρχοντικό Βαρελτζήδαινας	Πέτρα Λέσβου
Αρχοντικό Βελισσαροπούλου	Ερμούπολη
Αρχοντικό Γεωργίου Εμμανουήλ Αργυρού	Μεσαριά Θήρας
Αρχοντικό Κωνσταντόπουλου	Άργος
Αρχοντικό Μαλιόγκα	Σιάτιστα
Αρχοντικό Μίσιου	Ιωάννινα
Αρχοντικό Νικολαΐδη	Πόθια
Αρχοντικό Παπακωνσταντή	Λίνδος
Αρχοντικό Παυλίδη	Ρόδος
Αρχοντικό Παύλου Κουντουριώτη	Ύδρα
Αρχοντικό Σαράφογλου	Βέροια
Αρχοντικό Σωτηρίου Αναργύρου	Ντάπια Σπετσών
Αρχοντικό Τοπάλη	Μακρινίτσα
Αρχοντικό του Γεωργίου Σβαρτς	Αμπελάκια Λάρισας
Ασκηταριό Μικρής Ανάληψης Πρεσπών	Πρέσπες
Ασκληπιείο	Ακρόπολη Αθηνών
Άσπρος Πύργος	Σίφνος
Αστική Σχολή Ρόδου	Ρόδος (πόλη)
Αστυνομικός και Λιμενικός Σταθμός Τήλου	Τήλος
Αχειροποίητος	Θεσσαλονίκη
Αψίδα Γαλερίου	Θεσσαλονίκη
Β' Κουβελέϊκη σπηλιά	Αλεποχώρι Λακωνίας
Βάθρο της Νίκης του Παιωνίου	Ολυμπία
Βάθρο του Αγρίππα	Προπύλαια (Ακρόπολη Αθηνών)
Βαλιδέ Τζαμί	Μυτιλήνη
Βασιλική του Αγίου Αχιλλείου	Πρέσπες
Βασιλική του Αγίου Ισιδώρου	Χίος
Βασιλική (Γαλεριανό συγκρότημα)	Θεσσαλονίκη
Βασιλική έπαυλη Αγίας Τριάδας	Τυμπάκι
Βασιλική έπαυλη Κνωσού	Κνωσσός